mobile1	thanks ,comma i will look at it tonight .period
mobile2	she also wants us to hire everyone who is out on leave immediately instead of having them show up when released .period
mobile5	i fear death is making a strong push down the backstretch .period
mobile6	i've got a call into wes to see if these numbers were in the second current estimate or not .period
mobile7	this will be hard .period
mobile8	hopefully it cheered you up a bit .period
mobile9	we are working on this as we speak .period
mobile11	interesting ,comma are you around for a late lunch ?question-mark
mobile13	have a good evening .period
mobile14	sounds good to me .period
mobile15	yes i am here actually .period
mobile16	tonight is my anniversary .period
mobile17	thanks ,comma i think we have taken care of this .period
mobile18	will follow up today .period
mobile19	that's a lot of dollars .period
mobile20	are you going to join us for lunch ?question-mark
mobile21	thanks for the surprise .period
mobile24	i will have to check to see who handles the paralegal hiring .period
mobile25	i can't find it on my blackberry .period
mobile26	and how would i be going for work ?question-mark
mobile28	i hoped you did .period
mobile31	early to my appointment ,comma so i'm working some .period
mobile32	okay to make changes ,comma change out original .period
mobile33	that would probably be the easiest time to give them up .period
mobile38	we'll let you know .period
mobile39	do you want to eat lunch somewhere before ?question-mark
mobile43	other than the trigen deal ,comma let me know if there are other deals that are a problem and i will look into them .period
mobile45	davis had not yet updated the model for this .period
mobile47	yes i am coming twice .period
mobile50	sorry i'm losing it .period
mobile52	if not ,comma he's gone on tuesday .period
mobile54	thank you ,comma dear .period
mobile56	thanks so much for the message .period
mobile57	i would hope costs would be lower on future additions .period
mobile58	let's start with this and add more later .period
mobile60	let me know if i can do anything .period
mobile61	no ,comma but thank you for offering .period
mobile64	fuel is retained in kind from the shippers .period
mobile66	per deal ,comma if we don't reach agreement by noon ,comma we have to call credits for payment wednesday .period
mobile68	if so he probably will have to pay back .period
mobile69	he can't help himself .period
mobile72	i haven't heard back from steve at all .period
mobile73	i have already approved and forwarded .period
mobile74	still want to try and get it done this year .period
mobile76	thanks for your offer .period
mobile78	was it a car wreck ?question-mark
mobile79	let gary smith know today if you want him .period
mobile80	please forward to andy edison and stuart zisman .period
mobile82	how are we handling others in that group ?question-mark
mobile83	don't make it harder than it needs to be .period
mobile85	james should be in and i can tell him or steve where to get schedules .period
mobile86	yes and yes ,comma but it will take me another day or so for the announcement .period
mobile88	is the system running okay this morning ?question-mark
mobile89	is she done yet ?question-mark
mobile93	do you have copies of the agreements ?question-mark
mobile95	thanks for the quick turnaround .period
mobile97	have a good weekend .period
mobile98	ava please print and give to steve to bring to omaha .period
mobile99	i can then accept and get it on my calendar in the office .period
mobile100	i'm hoping i can bring alina and make a play date for chad .period
mobile103	see you on friday .period
mobile107	more bad enron news ?question-mark
mobile108	i think we are dong okay .period
mobile109	michael has his holiday performance .period
mobile114	the only change would be the date .period
mobile116	we have been looking into that form of delivering training .period
mobile118	the filing concerns various scheduling and balancing rules .period
mobile120	you don't need to get it signed ,comma just substitute the new pages .period
mobile121	please send to hartsoe for comment .period
mobile122	we are headed to austin tomorrow .period
mobile123	please call debbie and ask her to fax you a copy of the executed guaranty .period
mobile124	i didn't hear from ginger this week .period
mobile125	thus have nothing to destroy .period
mobile127	he is pretty tapped into it all .period
mobile128	i am out of town until friday .period
mobile129	wish me luck with linda .period
mobile130	yes ,comma i am playing .period
mobile131	can you call me at home ?question-mark
mobile133	you can call me if you want or else i am going to crash .period
mobile134	mostly a social call .period
mobile135	we will sign tomorrow and fund tuesday .period
mobile136	after i get all info i will probably consolidate and give to sharon for keeping but i think it makes sense for me to consolidate all info on these employees .period
mobile138	can you rough out a slide on rating agencies ?question-mark
mobile139	please call tomorrow if possible .period
mobile140	we are all fragile .period
mobile142	please forward all necessary data and models per the netco agreement .period
mobile143	we are waiting on the higher ups to fill us in on what we are negotiating .period
mobile144	it will probably be tomorrow .period
mobile148	i would like to attend if so .period
mobile149	it better not be about me !exclamation-point
mobile151	on first glance it looks like many of the items relate to capacity release or peoples .period
mobile152	he played goalie almost the entire game .period
mobile155	i can return earlier .period
mobile156	i am trying again .period
mobile160	i am on my way to heaven .period
mobile161	would you mind taking the lead on this ?question-mark
mobile163	shelley ,comma will you have time or interest in attending this informational meeting ?question-mark
mobile165	i have taken the time to listen to all of your concerns and have responded below appropriately .period
mobile166	do you want us to spend the money if the alternative is no content ?question-mark
mobile168	my feeling is that once they affirmatively decide they are going to florida ,comma you should say that i rented a house and that you are going to come over and stay with us for a few days .period
mobile169	i think that the costs may be high ,comma but i would like your evaluation of the product .period
mobile170	we agreed to have a children's church meeting tacked on to the end of the next children's ministry meeting .period
mobile171	obviously ,comma this is not an issue with huge time sensitivity .period
mobile174	i will bring john brindle .period
mobile175	so ,comma i went shopping today and saw lots of things !exclamation-point
mobile178	need you or john to step out .period
mobile179	we probably have to discuss trade behavior and margin .period
mobile182	chad thought we were on a treasure hunt .period
mobile183	i thought i sent jim an email over the weekend .period
mobile184	can't get anyone at enron to think that far ahead .period
mobile185	but i have been reading my emails along the way and know about all the meetings next week .period
mobile187	you can explain this to me next week or over the weekend .period
mobile189	i did talk to connie the travel broker and she said that she was just holding our visa stuff pending instructions from chris ivins .period
mobile190	by the way ,comma i met yesterday with an internal candidate who did not have requisite experience .period
mobile193	he would love anything about rocks .period
mobile194	i totally understand but we now have a real problem with regard to the timeline .period
mobile198	what do you hear ?question-mark
mobile199	i have received many replies that the message is undeliverable .period
mobile200	i asked what dan will be doing ,comma but the person i talked to didn't know .period
mobile201	thanks i needed that today !exclamation-point
mobile202	i will review them on monday .period
mobile203	maybe i should just stay there for good .period
mobile204	i think the benefits information already is in what we sent to katie caplan as well .period
mobile205	my only constraint is chad's noon soccer game .period
mobile206	no problem maria ,comma please contact rick .period
mobile209	i will try and arrange to sit down and look at the most recent numbers .period
mobile210	a bit behind on my emails .period
mobile211	then we can go to zainy brainy .period
mobile212	hope your trip to florida was good .period
mobile216	hi ,comma how are things there ?question-mark
mobile217	what is your issue sir ?question-mark
mobile220	what a nice note .period
mobile221	i told gary you could make the call .period
mobile223	i would rather fund seven days in advance each monday .period
mobile224	i think we should consider this request .period
mobile225	i'm supposed to talk to ben and steve today .period
mobile227	greg is not back yet either so we still don't know real numbers .period
mobile231	i'll check around i have a good friend who works there .period
mobile233	i'm on my way back there to do so .period
mobile234	i have no way of seeing the slide on my blackberry .period
mobile235	bound to be some media flack on this .period
mobile240	be back tomorrow and maybe we can visit .period
mobile243	i know this might push us to the point of her asking whether they can stay with us ,comma but i'm afraid the kids will spill the beans .period
mobile245	neal ,comma can you help with this ?question-mark
mobile246	haedicke has given me travis and mary cook as legal and i understand they are digging through the contracts .period
mobile253	best of luck and stay in touch .period
mobile255	john ,comma thanks for the update .period
mobile259	until we can answer these questions ,comma we cannot terminate anything .period
mobile260	i was answering janet's comment .period
mobile262	so should i drive tomorrow ?question-mark
mobile264	how would you explain the difference between the two ?question-mark
mobile265	suffice it to say all of these things will be taken care of before it funds .period
mobile267	do you think you will need me to come back into the office tonight ?question-mark
mobile269	if so send me an email and i will come up before i leave for the hanger .period
mobile270	i have a favor to ask .period
mobile274	i'm still in dallas !exclamation-point
mobile276	we are on the road to palacios .period
mobile277	we told them that we were keen to deal but needed commitment .period
mobile281	it reads like she is in .period
mobile282	oh my ,comma perhaps i've given you the wrong idea about the sophistication of chad's rock collection .period
mobile283	is cassandra there today ?question-mark
mobile284	let us know if you have suggestions on a replacement .period
mobile286	heather tells me there are only two remaining issues so i'll follow up on those .period
mobile287	i like nick and everett .period
mobile288	shouldn't be too hard though .period
mobile289	i saw an offer letter to teresa staab so if we didn't give it to her it's on the reserve list somewhere .period
mobile290	in a couple of weeks .period
mobile291	has dynegy made a specific request ?question-mark
mobile292	i am walking in now .period
mobile294	they have capacity now .period
mobile296	i am here today ,comma i am in stan's staff meeting .period
mobile297	unfortunately we do not know what the deal is .period
mobile299	will he come down wetheimer ?question-mark
mobile302	did you add the sections on what we want newco to do for the employees ?question-mark
mobile305	we are still transitioning and alina had a fit as we were leaving a friend's house to come to choir .period
mobile306	if the reimbursement doesn't show up then there is no offset and the dollars spent should end up in rate base .period
mobile309	she had your name on the list she pulled so i am confused .period
mobile310	a gift isn't necessary .period
mobile311	we are planning to attend ,comma although i am going to a networking happy hour at my old firm .period
mobile313	tell her to get my expense report done .period
mobile314	i am out of town on business tonight .period
mobile318	we need a process to deal with this .period
mobile319	i'm waiting until she comes home .period
mobile322	see you next week .period
mobile323	this is the neatest toy i have had .period
mobile324	it was in a yellow interoffice envelope ,comma real yellow ,comma not the regular manila colored .period
mobile326	i offered to form up a study effort with them since they would be a crucial shipper .period
mobile328	i heard we had preliminary good feedback from cadwalader on pledging contracts .period
mobile329	chris foster is in !exclamation-point
mobile331	and we can send out an email on our staff meeting on monday .period
mobile332	i've been thinking about them for several weeks and haven't made up my mind .period
mobile333	no ,comma but thanks .period
mobile334	they are more efficiently pooled .period
mobile335	this isn't the language that we agreed on and it will cause serious objections from my camp .period
mobile336	i will send them a letter telling them that we will be covering .period
mobile337	i have other things to worry about !exclamation-point
mobile340	hole is unlikely ,comma but is a real weak point in any sales discussion .period
mobile341	i may take the opportunity to run some errands .period
mobile342	this is a problem for timing of restart .period
mobile343	i will call you monday morning to discuss .period
mobile344	let's discuss in the morning .period
mobile346	thanks for yours and donna's efforts to get this before i left .period
mobile347	i should be back in the office on wednesday .period
mobile349	same camp as davies ,comma lagrasta .period
mobile352	i didn't understand we were borrowing them .period
mobile354	if he does not have it ,comma we will have to call trailblazer directly .period
mobile355	as a further indication of their confidence ,comma the deal team is spending three days in vail this week ,comma with family ,comma to recuperate .period
mobile357	michelle tells me their law firm is drafting changes to agreement as we speak .period
mobile358	just send the package to kevin ,comma we just need backup ,comma not presentations .period
mobile362	i think tim wants to move quickly .period
mobile363	if motley is in we are out of money .period
mobile365	i'm on a vacation day but have to stop by the office later today and will round these up .period
mobile366	please let james and kathy know .period
mobile367	i want to thank everyone involved .period
mobile369	having said that ,comma though ,comma the underlying inventory items would have to be evaluated by the lenders for residual value and liquidity .period
mobile370	what period does the max rate assumption cover ?question-mark
mobile374	there is a meeting in omaha we are attending on wednesday with mary kay and dave .period
mobile376	i'm open ,comma though .period
mobile379	forward it in to steve for approval .period
mobile380	still views that mark is out ,comma greg is temporary ,comma and stan is here for the company ,comma for better or worse .period
mobile381	let me know if the plan is different .period
mobile382	the price they paid recognized the debt was there ,comma if it is not there ,comma the price will be higher .period
mobile385	producers reacting to price management .period
mobile390	i will be listening in for a little while .period
mobile391	it has been very rough this week .period
mobile392	i'll sign it in counterpart ,comma then i'll find a fax somewhere and fax it back to you .period
mobile393	surely we can cover this from within virgo's team ?question-mark
mobile395	just wanted to touch base .period
mobile396	not like you'll get paid for it .period
mobile397	i am getting home early .period
mobile398	i would suggest that we tweak the language in the third paragraph to say that we remain willing to provide feedback ,comma instead of saying that we would like to .period
mobile399	thanks again for your help .period
mobile401	i'll be thinking of you .period
mobile402	has brian had his contract yet ?question-mark
mobile404	could you try ringing her ?question-mark
mobile405	what a crazy day .period
mobile407	right now its a pissing match between watson and the banks .period
mobile408	you didn't answer me about driving tomorrow .period
mobile409	do you need it today ?question-mark
mobile410	i intend to distribute something this week .period
mobile412	will call later to explain .period
mobile413	well that will be very similar to up here in the north country !exclamation-point
mobile414	joel will handle this .period
mobile415	the contract is a bit complicated .period
mobile416	steve gilbert is working on this .period
mobile423	what is going on ?question-mark
mobile425	your kind thoughts are appreciated .period
mobile426	tax gave us the same feedback .period
mobile427	it's easier to control money if we have the conversations .period
mobile430	there are several business issues outstanding .period
mobile431	i will be thinking of you .period
mobile434	john this message concerns me .period
mobile435	did we plan that ?question-mark
mobile436	the pedicure needs to be with someone else so it's at the same time .period
mobile437	this will make my week .period
mobile438	i'm leaving around noon tomorrow to catch a flight .period
mobile439	i am glad that things are going well .period
mobile441	i already had donna prepare a revised budget with people assigned directly to pipes and no cross pipe allocations .period
mobile442	need anything from target ?question-mark
mobile443	in the current environment ,comma i am less than confident i could sell the unsecured enron piece shortly .period
mobile444	lynn and steve will attend for me .period
mobile445	given the prior understanding we had that this transaction did not require board approval ,comma i do not think we can or should ask for that approval now .period
mobile446	do we need to meet before the meeting with socal ?question-mark
mobile448	i will be late on day one .period
mobile450	assume for now that we are running identical trading books as it should be easy to cut the ones we do not want .period
mobile452	i think i get this everyday now .period
mobile453	add it all up ,comma we have a problem .period
mobile455	i forgot to send the address list before we left for austin .period
mobile456	today has been hard for me .period
mobile457	let me know if i miss anything .period
mobile458	i am trying to drive and email at the same time .period
mobile460	i'll probably page you .period
mobile461	couldn't risk the uncertainty .period
mobile462	elizabeth brown will forward the capacity release data shortly .period
mobile464	call me to give me a heads up .period
mobile466	these three letters ,comma not one but three is very upsetting right before christmas .period
mobile467	and leave my school alone .period
mobile468	i will investigate further this afternoon to see if there are any alternatives .period
mobile469	i will be there .period
mobile471	i am hanging in and hanging on ,comma as is everyone else .period
mobile477	i pray this is a huge oversight but yet i received three letters .period
mobile478	would you please send runner to get this ?question-mark
mobile479	what is in the plan ?question-mark
mobile480	i suspect someone will be doing the power stuff .period
mobile482	i have no idea .period
mobile483	they said it was supposed to snow here .period
mobile484	i'll get you details .period
mobile485	do you and george have a thing going ?question-mark
mobile487	besides friday and monday afternoons i don't have any other planned time off .period
mobile488	if this has already been covered ,comma then i apologize .period
mobile489	anything exciting going on today ?question-mark
mobile490	i will approve the posting subject to the condition that it be internal only at this time .period
mobile491	budget allocation from glisan has been postponed .period
mobile492	he's ready and willing to be here any day we have something to discuss with him .period
mobile493	she may have been told she had people but nobody had started .period
mobile495	the document has been signed and we do not have an out for our board .period
mobile497	i'm looking forward to the long weekend !exclamation-point
mobile498	do we need to do anything here ?question-mark
mobile503	because there is traffic .period
mobile504	i am fine with this .period
mobile506	jane ,comma what about this thursday for lunch ?question-mark
mobile508	in other words let's make it look as binding as we can .period
mobile510	i will check into your thoughts and get back to you .period
mobile511	i also need the name of some apartments in london to stay in from jill whitehead .period
mobile514	i have been in contact with him ,comma and he is familiar with the issues .period
mobile515	presumably so do you .period
mobile518	i know he has a lot going and doesn't have the crystal ball that i and others are looking for .period
mobile519	what is happening to the stock price ?question-mark
mobile521	we have the data .period
mobile524	once you do ,comma you can never go back .period
mobile526	should i bring you something back ?question-mark
mobile532	however ,comma before we do anything ,comma i need to see what you are proposing and visit with rod .period
mobile533	where do i go for lunch ?question-mark
mobile534	let's discuss the charges .period
mobile535	we need a copy of whatever they are looking at .period
mobile536	and i can't turn my phone on .period
mobile537	a letter is being sent today .period
mobile538	i might have something at the office .period
mobile539	where do you want to meet to walk over there ?question-mark
mobile541	can you help with this one ?question-mark
mobile542	are things better for you at home tonight ?question-mark
mobile544	are you going to apply ?question-mark
mobile547	any news from redmond ?question-mark
mobile548	will you call me or should i call you ?question-mark
mobile552	fran ,comma yes please update .period
mobile553	let me know if it goes any lower .period
mobile558	presuming we can afford headcount ?question-mark
mobile559	milly is a seller .period
mobile561	i am almost speechless .period
mobile563	ava ,comma please put me on the list .period
mobile564	suggest you get facts before judging anyone .period
mobile565	i am now officially a blackberry addict .period
mobile566	have i mentioned how much i love houston traffic ?question-mark
mobile567	i would prefer that they have individual logins so we can audit who did what .period
mobile569	take what you can get .period
mobile571	boy ,comma i couldn't write too much on this thing !exclamation-point
mobile572	i have no documents on this transaction .period
mobile574	evidently ,comma waiver was received but prohibits us from selling assets or prepaying debt without their approval .period
mobile575	and yes i am learning how to use the blackberry reasonably well .period
mobile576	should systems manage the migration ?question-mark
mobile577	yes ,comma belize is supposed to be very good also ,comma but the island we would be going to is practically in belize .period
mobile579	is carol going back to swaps ?question-mark
mobile582	need before board meeting .period
mobile585	i am going to go to work tomorrow ,comma but i dread it .period
mobile586	i think we should stick to customer figures rather than mix customer and contract stats .period
mobile587	i've got a call into bowen .period
mobile588	i think that is the right answer .period
mobile589	we've attached conditions to our commitment that i'd like to preserve .period
mobile590	next time ask jim to call me .period
mobile593	i would think we could change to the new hotline almost immediately .period
mobile595	i copied the children's church materials yesterday and will have gaby drop them off at church tomorrow .period
mobile596	i'm glad you liked it .period
mobile597	thanks for all your support .period
mobile600	i am out of town on business .period
mobile601	i've never worked with her .period
mobile602	get with mary for format .period
mobile605	i hope you are feeling better .period
mobile606	i will be in the office tomorrow .period
mobile607	i'm glad she likes her tree .period
mobile608	are you getting all the information you need ?question-mark
mobile609	have a great trip .period
mobile611	tried reaching you earlier .period
mobile615	i would expect an answer asap .period
mobile616	going home to pack and then headed to dallas .period
mobile617	i think your outlined measures sound fine .period
mobile619	did you talk to ava this morning ?question-mark
mobile620	we have lots of paper stuff .period
mobile621	we can discuss options early next week .period
mobile623	it's not looking too good is it ?question-mark
mobile624	has anyone else heard anything ?question-mark
mobile625	i went to see a doctor .period
mobile628	hope you don't freeze tonight .period
mobile629	i want to verify with litigation that the scope of the lawsuits regarding the el paso swaps would preclude their inclusion in a master netting agreement .period
mobile630	that is exactly what i would like you to do .period
mobile631	we have beans ,comma plus one will be cooking trash .period
mobile632	did you see laura's message .period ?question-mark
mobile635	i'm in a board meeting sending you an email on my new skytell pager .period
mobile637	you better be nice to me when i get back .period
mobile638	i'll presume it is dead until i hear otherwise .period
mobile640	going to new york tonight and will be home tuesday night .period
mobile641	i'll get you one .period
mobile642	seems unusual to me .period
mobile644	i just tracked down steve .period
mobile645	i love my blackberry ,comma but still getting used to typing on it .period
mobile646	i thought it had gone to all of enron .period
mobile647	what will happen to this project ?question-mark
mobile649	mark ellenberg is off for passover .period
mobile650	he was not aware of what was going on ,comma and he wants to be advised before the money is paid .period
mobile651	conference call with partners on tuesday .period
mobile652	are you not hearing back from my people on this ?question-mark
mobile655	i'm out at a seminar ,comma but joe dilg is working on analysis .period
mobile656	although not a bunch of weekend work ,comma this week has more than made up for it !exclamation-point
mobile657	yes we need to get it in asap .period
mobile658	i am snowed under and out of the office .period
mobile659	i plan to be in the office tomorrow .period
mobile661	i know it doesn't help much ,comma but i'm not sure what you can tell everyone at this point .period
mobile670	but it is quite powerful for communications and managing a group while traveling .period
mobile671	i'll just have her call tracy .period
mobile674	i am looking forward to the salad .period
mobile676	we're planning to go to west virginia for christmas .period
mobile681	you can talk to becky !exclamation-point
mobile682	so i guess we'll have to check back in with fran .period
mobile683	met with partners in san francisco .period
mobile684	i'm in a meeting but will check when i get back to my office .period
mobile688	i talked to duran .period
mobile692	i'd send this to sarah and ryan for their database .period
mobile693	i agreed terms with greg .period
mobile696	i'll see what i can find out for you .period
mobile697	what did you and ava decide to do ?question-mark
mobile698	i will talk with jim fallon and lawyers .period
mobile699	i am at the lake .period
mobile700	i wish he would leave deerfield alone .period
mobile702	i told you silly .period
mobile703	i know it is our core business ,comma but it might be quicker than selling brazil .period
mobile704	i had specifically taken this deal to jeff for approval ,comma and he had decided to not go forward at that point in time .period
mobile706	wednesday is definitely a hot chocolate day .period
mobile707	can you do the gallup contracts as well ?question-mark
mobile708	apologize to steve dowd for me .period
mobile709	thanks for your concern .period
mobile712	hillis set up a room if you would like to attend .period
mobile713	thursday works better for me .period
mobile714	unless you can think of a reason why not it makes it simpler ,comma i think .period
mobile717	will reveal as appropriate .period
mobile721	chase back office and their restart plan updates individually .period
mobile723	lynn checked with fran and she told her coordinator .period
mobile728	i am all over it .period
mobile729	i am on a plane ,comma sorry .period
mobile734	i have not heard from anyone yet as to the expected transition time frame .period
mobile737	i guess that's additive to my stretch ?question-mark
mobile739	pira thinks power suppliers in california should be worried about getting paid the long term contracts rates .period
mobile741	while i am out of the office today please keep kevin howard up to speed on what you see and hear .period
mobile742	he especially loved the special kiss .period
mobile743	did you hear alice quit ?question-mark
mobile745	i think that we should enforce the agreement .period
mobile747	heading in to see moody's .period
mobile748	he's checking his email now and is expecting your call .period
mobile749	i told you that you were a trouble maker !exclamation-point
mobile750	out of office but have people working on info .period
mobile751	little value to the pipes .period
mobile752	just looking to gossip .period
mobile753	did he get a signing bonus ?question-mark
mobile754	would you two think about those who helped us so we can attempt to get some award to those who really helped us out here ?question-mark
mobile756	what is the mood ?question-mark
mobile757	tracey is coming next weekend .period
mobile758	hi i'm in the board meeting but it shouldn't last much longer .period
mobile759	i have some more data coming .period
mobile761	still hustling to find dollars for the quarter end .period
mobile762	do we want to contest ,comma if possible ?question-mark
mobile763	jim should call with a phone number so that i don't have to come over there .period
mobile764	john millar to report .period
mobile765	did ginger give you any read on how long to translate our documents or when they might be sent to kazakhstan ?question-mark
mobile767	i've been asked to provide a statement to governor knowles on friday morning about enron's situation and the effect on the alaska project .period
mobile769	probably a monday meeting of some of our marketing types to work on this one .period
mobile771	never mind ,comma i already deleted it .period
mobile773	i am out of office this week and will be unable to fill out questionnaire .period
mobile774	john here is a note from jane about some things marketing wants to talk about at our meeting .period
mobile775	we can follow up in more detail later on the structure but we will also work on mitigating the margin required due to falling prices as the pipe deal closes and resources can be redeployed .period
mobile776	when do you have to be there ?question-mark
mobile778	he says he has some ideas .period
mobile781	i hear tim has huge problems .period
mobile782	they are to execute the mandate letter by close of business today .period
mobile783	we are about to leave heaven !exclamation-point
mobile784	rescinding is what you meant to say .period
mobile785	i am on my way .period
mobile786	please leave it to brian .period
mobile788	i sent you a message earlier today .period
mobile789	i can't remember who sent it ,comma and the ones i've reviewed don't have the info .period
mobile790	i think that we got a good deal and you should not be getting dinged for that deal .period
mobile791	i am continuing to handle some issues from home on keyspan and some florida contracts .period
mobile792	lynn ,comma are you going to be able to attend the meeting ?question-mark
mobile793	can you get it from the price screen rather than the internet ?question-mark
mobile794	do we need to discuss ?question-mark
mobile796	shelly ,comma just wanted to update you on a few things .period
mobile797	just playing with you !exclamation-point
mobile798	shelley ,comma i just found out this message did not go .period
mobile800	i'm at the doctor's office ,comma should be in later .period
mobile802	tammie please forward to duran .period
mobile803	looking for some gift hints from you .period
mobile804	if we are not sure we can keep customers week to week why are we even doing this ?question-mark
mobile805	have a good trip .period
mobile806	i haven't visited with stan lately .period
mobile807	they may want to discuss with you .period
mobile808	i hope to have before the end of the day .period
mobile811	what's your phone number ?question-mark
mobile813	neither bowen ,comma nor myself ,comma know if any decision has been reached by the lenders at this time .period
mobile814	fine with me if you carry on and give me an assignment .period
mobile815	muller was going to send vince the copy of the contract indicating the section to vince that required the turnover just to make sure we were doing the right thing .period
mobile816	i received word that the switch deal is off .period
mobile817	have you talked to somerholder ?question-mark
mobile819	do they start over or do they pick up where they left off ?question-mark
mobile820	i would like to get a review with stan and jeff to decide .period
mobile821	thanks for checking with me .period
mobile822	this is very sensitive .period
mobile823	let's take this up when chris and i are in houston .period
mobile824	can you please review and get back to tim ?question-mark
mobile826	what is the stock price doing ?question-mark
mobile829	this financing shows up as minority interest .period
mobile830	thank you for your call .period
mobile831	can we have them until we move ?question-mark
mobile833	please respond if anyone has a different view .period
mobile834	on the plane ,comma doors closing .period
mobile835	what did mark say ?question-mark
mobile836	lisa mellencamp on any issues regarding pending litigation .period
mobile837	i'll catch up with you tomorrow .period
mobile839	treasa knows the details .period
mobile840	are you in today ?question-mark
mobile841	have you done any deals yet ?question-mark
mobile845	talk to you tomorrow .period
mobile846	i'm currently at the loading dock loading equipment for the hanger .period
mobile851	not in the near future .period
mobile852	others from my staff will attend and i'll catch up when i return .period
mobile853	the meteor shower was incredible last night .period
mobile854	let me know where you might be .period
mobile855	i'll review and send you a note over the weekend .period
mobile856	good to know it exists .period
mobile858	wasn't nearly as bad as i thought .period
mobile860	do you know anything ?question-mark
mobile862	so no we didn't implement skyline as proposed and nothing is pending .period
mobile863	i will forward to oxley to make him aware that there is something coming .period
mobile865	i am assuming elizabeth will be in to help me ?question-mark
mobile866	i'll let you know when i figure it out !exclamation-point
mobile867	i think that pam butler called him .period
mobile868	would you mind doing the following ?question-mark
mobile869	we need to come home ,comma lynda is about to break me .period
mobile871	dallas and i am not coming back !exclamation-point
mobile874	i have my cell phone and my blackberry so i can get email .period
mobile876	i didn't read it all but assume it is okay .period
mobile877	i'll come have a beer with you guys later .period
mobile878	the socal meeting was very beneficial .period
mobile880	selling wessex is the right move for everyone .period
mobile881	have a great evening !exclamation-point
mobile882	but i believe answer will be yes .period
mobile885	i just sent alice an email asking for help finding a number for dad's life insurance company .period
mobile886	while it was very scary for helen ,comma i'm satisfied with randy's reply .period
mobile888	i think we do need to discuss contracts for both of them and find the money for them .period
mobile891	we just need a sitter .period
mobile892	i will leave my blackberry on .period
mobile893	we must be consistent .period
mobile895	did you tell steve ?question-mark
mobile896	she has absolutely everything .period
mobile897	on the other deal ,comma they are back to total capital expenditures and not just expansion dollars .period
mobile899	is this the conference rate ?question-mark
mobile901	when things get speculative the language always gets scary .period
mobile902	i'm not planning on doing anything this week .period
mobile903	thanks for taking the lead on this .period
mobile904	kay mann is going to take the lead on this .period
mobile905	this is a most unfortunate news release .period
mobile907	this is good i think .period
mobile908	it is not surprising .period
mobile909	they will be getting new results over the weekend and it should be indicative of trends .period
mobile910	let me know how i can help .period
mobile911	please send to gary smith .period
mobile912	we can have wine and catch up .period
mobile913	an increase in the fee for this substantial change of the deal is market .period
mobile915	my blackberry did not pick up the email you were responding to .period
mobile916	also know that i won't be talking to jeff until next week .period
mobile917	we plan on reviewing with stan on monday .period
mobile918	you just can't work without me can you ?question-mark
mobile919	don't they have some conflicts here ?question-mark
mobile921	on my way down .period
mobile922	suzanne emailed me that randi thompson ,comma the head of kidsave ,comma is in kazakstan right now and will be sending out an email to the kidsave families .period
mobile923	please pass along my thanks ,comma though .period
mobile924	obviously we shouldn't bother with bridgeline ,comma peoples or anything like that .period
mobile925	today we're going to an astros practice and then we catch our flight home .period
mobile926	can you get me the calger letter done ?question-mark
mobile927	i am getting the feeling that these messages don't get through .period
mobile928	no sign of chuck and not responding to messages .period
mobile929	twanda would you please call joe dilg and ask him when he will have his analysis of diomedes' issues completed ?question-mark
mobile930	i had a long meeting with their chief credit officer from london yesterday and he agreed to put someone here from day one capable of making decisions .period
mobile931	we have suspended our neutral reference practice in light of the layoffs yesterday .period
mobile935	they are firmly sitting on the fence .period
mobile936	happy holidays to you and your staff .period
mobile938	her in laws won't be there ,comma but friends will be .period
mobile939	can't use my parents because they'll be at lisa bowman's wedding .period
mobile942	what is our cash needs over the week to ten days ?question-mark
mobile943	thanks for your leadership on this issue .period
mobile944	is this a standard language ?question-mark
mobile947	i'm on a conference call .period
mobile948	probably need additional review by someone now ,comma given the current situation .period
mobile949	i will call gary and fran on wednesday hope that they are in the office and can assist me .period
mobile951	no obligation to pay .period
mobile952	i talked to peggy last night ,comma and we are on for christmas dinner with them .period
mobile953	what does hunter think ?question-mark
mobile955	money wise that is .period
mobile956	will let you know how call goes in morning .period
mobile960	just so you know ,comma i'm still in the waiting room .period
mobile962	trip was good i presume ?question-mark
mobile965	also can you make sure sue and kent have seen it ?question-mark
mobile966	that was so sweet .period
mobile967	anxious to hear how the paging worked for you .period
mobile968	as i am out if you need anything please contact oxley directly .period
mobile971	marisa sent the invoices .period
mobile972	we need to bring them along slowly .period
mobile974	get with david lund .period
mobile976	weather is bad here .period
mobile978	i have asked lizzette to look at this for you .period
mobile980	in a meeting with your guys now .period
mobile981	that is fine ,comma but i do have to get cameron today ,comma so let shanna know .period
mobile982	i am up with stan if you need me .period
mobile983	i'll try to sit down with him next week .period
mobile984	the desire ,comma however ,comma is related to the possibility of spending a fair amount of time in diving locations during my honeymoon .period
mobile985	how long can you guys shop ?question-mark
mobile986	he will be available via phone .period
mobile987	is terry pulling his hair out yet ?question-mark
mobile988	glad you weren't in an accident today .period
mobile989	steve harris usually has some good stuff from budget presentations .period
mobile991	thanks for your kind words .period
mobile992	i am still hearing rumors about an involuntary by haynes and boone .period
mobile996	since this is the first time we received this form i just wanted to confirm .period
mobile998	talk to you later .period
mobile999	i can't recall if we put any provision on that issue in the bid template or not .period
mobile1000	i have tried my best over the years to improve deal quality to an audience that usually told me that i was irrelevant .period
mobile1003	hopefully this can wait until monday .period
mobile1005	i'm fully recovered and back on pace .period
mobile1006	i'm volunteering at school this afternoon and can't open the attachment on my blackberry .period
mobile1007	i am not concerned with the brown money .period
mobile1008	i'm planning to drive back today ,comma and will take tomorrow off .period
mobile1009	generally he doesn't like these but i am okay if teresa wants to let them .period
mobile1010	i'll be somewhere between pueblo and the royal gorge ,comma but i'll try to stop and patch in .period
mobile1011	no employment claims for gas or power .period
mobile1012	cash is king for now and we need the pricing to get the rest of the cash .period
mobile1013	i still would like to discuss status of the program when you are available .period
mobile1015	on my way back .period
mobile1016	we can work around these plans if you prefer .period
mobile1017	i met with dave duran yesterday to get his signature .period
mobile1018	i am freaking out !exclamation-point
mobile1021	maybe you can leave early .period
mobile1023	i can either plant this saturday or next .period
mobile1025	what happened with brent price ?question-mark
mobile1026	will be a while .period
mobile1028	why do you ask ?question-mark
mobile1029	however ,comma i do not feel that the accounts for the resources should be disabled .period
mobile1030	as you can see not everybody is always on board .period
mobile1031	don't forget to pray .period
mobile1033	okay i asked gary to have you decide on michael .period
mobile1038	i love you too .period
mobile1039	kevin howard will not be able to accompany us to phoenix .period
mobile1040	ava ,comma please be sure tuesday afternoon is blocked for me to spend with the teams .period
mobile1041	just told them i thought it would be impossible .period
mobile1044	mike ,comma are you aware of this ?question-mark
mobile1047	i'd be happy to .period
mobile1049	this looks fine with me .period
mobile1050	so how many times can people ask me if i am going to get let go this holiday ?question-mark
mobile1051	does the state have copies of all programs ?question-mark
mobile1052	my focus is on possibly dislodging money for orlando .period
mobile1054	she has a web address .period
mobile1055	you have a lot of holes in your plan .period
mobile1057	i agree since i am at the bank right now .period
mobile1058	did you not read my first email ?question-mark
mobile1059	i was planning to attend .period
mobile1060	that would be great .period
mobile1061	fannin is a mess by the dome and elsewhere .period
mobile1063	thank you for your prompt reply .period
mobile1065	i just want to make sure louise has the best data points for making a decision on my proposal of this morning .period
mobile1067	can you wait until monday ?question-mark
mobile1070	can you help me here ?question-mark
mobile1071	i know several who work there .period
mobile1072	i changed that in one prior draft .period
mobile1075	probably will be working .period
mobile1076	given that the new structure requires a new market ,comma new rating agency process and new documentation ,comma we are effectively documenting and selling a new second transaction .period
mobile1077	see you in enron house when i get back .period
mobile1078	what is the cost issue ?question-mark
mobile1079	i will resend to you .period
mobile1080	please send me an email .period
mobile1081	i will circle back with everyone later today .period
mobile1084	banks want to exclude goodwill .period
mobile1088	we are trying to get all issues resolved as quickly as possible .period
mobile1090	don't make me pull tapes on whether you understood our fee .period
mobile1092	i will review with marketing and the team when i get back .period
mobile1093	is that enough for this week ?question-mark
mobile1094	probably won't have anything to tell late tonight .period
mobile1095	yes i will be back tonight .period
mobile1096	i think i feel better ,comma but i would like some comfort from the lawyer in the crew .period
mobile1098	i can look at it tonight .period
mobile1099	it was a heroic effort on a very difficult and unusual financing .period
mobile1101	we should be in a good negotiating position .period
mobile1102	i'm in a meeting until noon .period
mobile1103	don't know how that happened .period
mobile1104	you snooze you lose !exclamation-point
mobile1105	i'll call you to set up a time .period
mobile1107	you might forward the email to ben ,comma i think pompano has a queue spot .period
mobile1109	there is a god .period
mobile1110	team is bradford and carol saint clair on master netting agreement .period
mobile1111	if she isn't in for some reason ,comma i'll ask for your help .period
mobile1113	might include proposals with respect to alaska .period
mobile1115	if not ,comma julie and i will track them down this afternoon .period
mobile1117	please send it to both of us .period
mobile1118	i will if i want to .period
mobile1119	mike mcgowan in omaha would be the only one who might know .period
mobile1120	issue on post bankruptcy price risk issue remains .period
mobile1122	jan ,comma sorry for the inconvenience .period
mobile1123	and ,comma if you want she could use a photo album or scrapbook for her story .period
mobile1124	told him we'd expect him to turn the deals quickly .period
mobile1125	we are on a plane coming back .period
mobile1127	finally ,comma i would delete the paragraph about lawyers .period
mobile1128	also ,comma regarding the cash flow from canada .period
mobile1129	i am sorry you had to come in .period
mobile1131	that is one of the things we are working on .period
mobile1132	previously he had left it up to jeff who had said no .period
mobile1134	only as a last resort should we want to redo .period
mobile1135	i got it ,comma pal .period
mobile1137	i'm out today ,comma so don't wait on me to file .period
mobile1140	ben could tell him about pompano .period
mobile1141	i think this just happened friday .period
mobile1142	if you need a signature fax it to the hotel .period
mobile1146	i think we should put a number on the table .period
mobile1148	given gary's presentation on bonus timing i plan to turn in my recommendation today .period
mobile1149	tell everyone to calm down and get their work done .period
mobile1150	let me know when you get this .period
mobile1151	i wanted to go drinking with you .period
mobile1154	jordan is taking christina mordant's last job ,comma corporate development .period
mobile1157	i will make meatloaf for dinner when i get home .period
mobile1159	dan wanted to tell you that there is leftover potato casserole on the top shelf of the fridge .period
mobile1160	we don't seem to have any positive income there .period
mobile1161	i will be back friday .period
mobile1162	would you mind getting with diane on the issue of online harassment prevention training ?question-mark
mobile1163	love to all ,comma kay .period
mobile1167	gary i will call you when i get back in the office .period
mobile1172	please make sure bob kelley is on the list .period
mobile1175	can you send me an invitation for the two meetings on monday in outlook ?question-mark
mobile1176	i think it's over now .period
mobile1177	gary made it sound like you had decided to lose michael .period
mobile1178	it's not working very well .period
mobile1180	i think that is right ,comma but i do not have the data to confirm that .period
mobile1182	i agree with jim .period
mobile1183	i trust that everyone already understands what is contracted and the only concern is our recontracting capability .period
mobile1184	i need your home cell or whatever .period
mobile1186	mike ,comma i'm afraid i have a conflict in san diego on behalf of ken lay those days .period
mobile1187	let him pursue his claims with everyone else .period
mobile1188	there is an article about the legal department .period
mobile1190	if all goes well ,comma i think we can be done by mid october .period
mobile1192	if not can i call you ?question-mark
mobile1195	as prices fall we effectively begin to repay the transaction .period
mobile1197	she is a baylor graduate and is very nice .period
mobile1199	we've already eliminated his speech therapy .period
mobile1200	but i would like a waiver ,comma so i think we should consider some sort of payment .period
mobile1202	ava please put on my calendar .period
mobile1203	then there is adoption stuff and then there is world news .period
mobile1204	i also just received my blackberry ,comma cool .period
mobile1206	confirmed with mark taylor .period
mobile1207	i am really hoping that you will have some time to be my therapist this weekend .period
mobile1210	do you still need me to sign something ?question-mark
mobile1213	so does this mean mimi's email is up and running ?question-mark
mobile1214	if we want to sell then we need to file and wait .period
mobile1215	i have a quick meeting with legal on interpreting the contract ambiguity regarding curtailment this morning and can fill you in on all those discussions shortly .period
mobile1217	i will be checking up with lisa .period
mobile1218	i will likely not be available .period
mobile1219	fran is trying to get with mcmahon to get his take on them .period
mobile1221	and also can you start planning to have infinity up and running on day one ?question-mark
mobile1225	the issue is that in order to sell the units there is a public disclosure of the units being in rawhide which may have some more issues .period
mobile1226	still waiting on decision .period
mobile1227	all i need is for you to prepare a one sentence description of the set off deal .period
mobile1232	it is probably a good idea to go and stay downtown .period
mobile1235	it consists of rocks he has picked up at the park and a few gems he bought at a museum .period
mobile1237	we are working on it but in the grand scheme of things it is kind of a back burner issue .period
mobile1238	how can we get these answers ?question-mark
mobile1239	i am trying to get a decision ,comma but i think we need to maintain flexibility ,comma if at all possible .period
mobile1240	you hang in there too .period
mobile1241	i received three letters stating that since i am no longer with enron i can access and move my savings plan .period
mobile1247	both of us are still here .period
mobile1249	did you send out a global message from me ?question-mark
mobile1251	not even in yet .period
mobile1252	barry ,comma hope that you had a great christmas .period
mobile1256	i don't want to let my nanny go home if you think you need me .period
mobile1258	the rest is a byproduct of slapshot .period
mobile1259	heightened state of awareness down there with the flow of info .period
mobile1260	disney was great and i've been to eight baseball games .period
mobile1261	still ,comma i'm always up for opera .period
mobile1263	ava ,comma please put on my calendar .period
mobile1264	we will keep trying .period
mobile1265	much better than carrying a laptop .period
mobile1266	i know a live plant is risky ,comma but i figured people buy cut trees and stick them in water ,comma so what the heck .period
mobile1268	email the consent to me .period
mobile1271	how soon do you need it ?question-mark
mobile1272	i think what you are proposing should be fine but it would help to understand the background .period
mobile1273	how are things with you ?question-mark
mobile1275	michael said his day was rotten .period
mobile1276	dan boyle mentioned that today is the deadline for the rawhide amendment .period
mobile1277	nothing but good news everyday .period
mobile1278	not good really for me as i was finally hoping to get paid this year .period
mobile1279	eric boyt is pulling deal numbers and details to match to documents .period
mobile1281	message is getting through .period
mobile1283	john ,comma can you give konni a call ?question-mark
mobile1285	i left a message .period
mobile1288	kevin needs to bird dog the folks we met with today .period
mobile1289	i guess this is okay if you are .period
mobile1290	i am not aware of any .period
mobile1293	perhaps there was a glitch .period
mobile1296	also hope you can make sense of this email .period
mobile1297	i hope to provide you with a more detailed answer after consulting reliable travel guides and weather almanacs .period
mobile1299	what number should he call you on ?question-mark
mobile1300	we are proceeding with a great reception so far .period
mobile1301	you can reply via email .period
mobile1302	i'll find someone to do it .period
mobile1304	there was a rawhide bankers meeting late yesterday to consider enron's request to delay the call by several weeks .period
mobile1305	geez ,comma i sound pathetic .period
mobile1306	if we agreed to do so ,comma then our records should reflect that service date .period
mobile1309	i have the cable now if you are still here .period
mobile1310	we will need to allocate individual seats early next week .period
mobile1313	i would like to discuss .period
mobile1315	i would like it paid through i buy it .period
mobile1317	i do not believe that we are in violation of any transfer restrictions .period
mobile1318	i think these will be just fine .period
mobile1320	ava ,comma do we need to worry about this ?question-mark
mobile1323	what happened to savita ?question-mark
mobile1324	are you feeling better ?question-mark
mobile1325	you have a nice holiday too .period
mobile1328	i would be worried if my son was walking around in women's shoes !exclamation-point
mobile1329	we need to talk about this month .period
mobile1330	how is it going ?question-mark
mobile1331	any questions about these items and you can typically get the quickest estimate or actual from me .period
mobile1333	you probably do that too when no one's around !exclamation-point
mobile1338	what happened to the guy with the paper to sign ?question-mark
mobile1339	i tried that to no avail .period
mobile1341	that's not the behavior that i was looking for .period
mobile1342	i was trying to remember what bobby said .period
mobile1343	i'm quite interested as i told lyn .period
mobile1344	either we call every commercial person a trader or we periodically acknowledge the existence of marketers .period
mobile1345	also ,comma the last sentence of that paragraph should ask whether she would like to pursue that option instead of asking about her availability .period
mobile1347	maybe stuff we do more of next year .period
mobile1348	i'll see if we can incorporate some of this in the changes we are proposing .period
mobile1349	how do you like the blackberry ?question-mark
mobile1350	we are waiting on the cold front .period
mobile1351	john keffer is the one i know best .period
mobile1354	i have a direct recommendation from my travel obsessed friend ,comma jessica ,comma who just got certified there a couple months ago and has provided me with both information and endorsements .period
mobile1357	neil has been asking around .period
mobile1358	we are having fun .period
mobile1360	i have rates and capacity utilization information ready .period
mobile1361	got your back while you pick up wine .period
mobile1363	what is the name of the website where all of this information resides ?question-mark
mobile1365	this relates to a junior assistant who has been part of my group .period
mobile1368	ava please print attachment and give to steve to bring to omaha for me .period
mobile1371	i'm big on the blackberry .period
mobile1372	tried to call but couldn't reach you .period
mobile1373	let me know if i can help .period
mobile1374	i saw you called but thought it is probably too late to reply .period
mobile1375	i had a last minute meeting come up .period
mobile1376	i will call when i can .period
mobile1377	we'll be back sunday .period
mobile1381	i have been working those .period
mobile1383	maybe michael will go to quil tomorrow .period
mobile1384	sorry to keep you in suspense !exclamation-point
mobile1386	i need to go to stan's office .period
mobile1389	we are a little light on disposable cups .period
mobile1390	i don't know if we have the trailblazer information in house .period
mobile1395	the master agreement references the trading business .period
mobile1397	are we ready for this on monday ?question-mark
mobile1398	that is not true .period
mobile1400	i will handle this afternoon .period
mobile1404	i already deleted it .period
mobile1405	as you know ,comma it isn't easy .period
mobile1408	i assume that you are working with terrie james on this .period
mobile1409	yup he can do it by phone .period
mobile1411	have to be careful that you don't lose historical data for rate purposes .period
mobile1412	brief discussion on noise in the market he's hearing and reading ,comma etcetera .period
mobile1413	please forward to kevin howard .period
mobile1415	isn't that about the way it could happen ?question-mark
mobile1416	thanks for the plant .period
mobile1417	i'm just pulling in to the garage and will call back in a minute .period
mobile1419	are you two talking ?question-mark
mobile1423	the answer depends ,comma so we need to be careful about how we answer it .period
mobile1424	i'm fine with that see you monday .period
mobile1427	go ahead and turn the next draft with pinnacle west ,comma too .period
mobile1428	i understand that while bowen signed draw requests on thursday ,comma legal had ok'd .period
mobile1431	every day there is something new ,comma different ,comma and bad about us .period
mobile1434	the neat thing is that you use you're regular cell number .period
mobile1435	let's wait until monday .period
mobile1438	we have been on the go all day and it has been after business hours when i've gotten back to the house so i didn't get to talk to you .period
mobile1439	are you on the diet with me ?question-mark
mobile1440	that would likely be an expensive option .period
mobile1441	we haven't made that decision here though .period
mobile1443	i decided that i am going to stay here !exclamation-point
mobile1444	i have forwarded to kelly .period
mobile1447	only one possible variance from what we had previously heard .period
mobile1450	any chance of doing the one penny test with the credit departments of the top couple of customers ?question-mark
mobile1451	board meeting running long .period
mobile1453	have a great day !exclamation-point
mobile1457	lavo called it ,comma never mind though .period
mobile1458	i don't think we need to make a big deal of this .period
mobile1459	the replacement would need to fly to philadelphia monday night and would get back late on tuesday night .period
mobile1460	when do we review with el paso ?question-mark
mobile1462	i just had my head in the clouds .period
mobile1463	dash was signed back in october and we determined that board approval was not needed .period
mobile1464	i will not be able to attend .period
mobile1465	would you have john send me a message ?question-mark
mobile1466	i would like to make sure we know the definition per group .period
mobile1467	i've been in with kaminski and bowen all morning so i have limited feedback today .period
mobile1469	thanks dan ,comma we'll look after him .period
mobile1470	wonder what next week will bring .period
mobile1475	can you talk to the appropriate commercial people and get them to decide ?question-mark
mobile1477	they are ranked by volume and include type of contract ,comma entity name ,comma credit limits ,comma etcetera .period
mobile1479	if you need me to call tonight leave me an email or phone mail and i will call when i get in .period
mobile1481	what would you think about trying to coordinate hair appointments on saturday ?question-mark
mobile1482	chad would like to go to zainy brainy and i need to exchange some things at gymboree .period
mobile1483	so you're ignoring me .period
mobile1484	i think i'm okay .period
mobile1485	could you print theirs and ours for me since i may not make it to my desk before i come over ?question-mark
mobile1486	where are they hitting the books at ?question-mark
mobile1487	your voice cheered me up .period
mobile1488	they're not having the baby then .period
mobile1492	today ,comma i understand legal is less comfortable .period
mobile1496	i think there are three deals .period
mobile1497	have a happy thanksgiving .period
mobile1498	we will keep you posted .period
mobile1500	i am really not wanting to come back .period
mobile1501	like the ideas ,comma i'll be in tomorrow ,comma let's chat then .period
mobile1502	do we have anyone in portland ?question-mark
mobile1504	i spoke with lara robinson this morning .period
mobile1505	chip schneider makes that call .period
mobile1506	if not ,comma i can try information in omaha .period
mobile1507	okay i thought it was in washington state .period
mobile1509	we are sitting in weil's offices ,comma waiting to negotiate .period
mobile1510	tracy and jim are trying to track down six more copies .period
mobile1512	will get back to you .period
mobile1513	i am on blackberry and missed the end of the talking points .period
mobile1514	we will make some minor changes at the hanger but we will leave it up and ready to go .period
mobile1515	hope you guys are doing fine .period
mobile1516	are you going to call ?question-mark
mobile1518	in my car on the way to the office from the airport .period
mobile1520	i hope you went .period
mobile1521	they have to go away and have a think .period
mobile1522	i just found a sympathy card from karen heathman in my briefcase .period
mobile1523	has it been mentioned yet ?question-mark
mobile1525	kelly ferrari will have the name of a chauffeur company .period
mobile1526	well i guess from what is taking place that dynegy has backed out of the deal .period
mobile1527	i want to get all of that stuff cleaned up .period
mobile1529	we will address tomorrow with stan .period
mobile1530	i would be glad to participate .period
mobile1531	are linde and kim available to assist rod ?question-mark
mobile1534	this is all so unreal .period
mobile1535	will give you more shortly .period
mobile1536	if it has to be pushed to next year ,comma that works ,comma but if it can be done it needs to be .period
mobile1537	sorry for the delay .period
mobile1538	let me know if there is any kind of problem in responding to rod .period
mobile1539	had a great meeting .period
mobile1540	i knew things were bad based on what you said .period
mobile1541	at that time i sidelined the issue as it was complex ,comma bearing in mind everything else that was going on .period
mobile1542	please coordinate with him .period
mobile1543	in kansas city today closing a deal with missouri gas .period
mobile1544	what level of detail do you need ?question-mark
mobile1547	let's stay downtown then .period
mobile1549	you have approval to submit a request to the cash committee via doug sewell .period
mobile1550	how did you make sure it was the right set ?question-mark
mobile1553	it has made a big difference .period
mobile1554	hope everything is going okay at home .period
mobile1555	i know trey and cam will be there .period
mobile1557	please stay on top of the security issue .period
mobile1558	if possible ,comma i'd like to get amy's opinion .period
mobile1559	we are currently working on options to have the roles each of the resources you have identified performed by the resources in the estate .period
mobile1560	as you know ,comma this stinks .period
mobile1561	i'll get with him by phone to confirm .period
mobile1568	have we assigned employees to netco ?question-mark
mobile1571	it is true i have other offers ,comma but none are new .period
mobile1573	am i getting a good package ?question-mark
mobile1575	we went to palacios to fish .period
mobile1578	i have never seen such courage and strength in an uncertain environment .period
mobile1579	let me know if i can be of help .period
mobile1580	hope all is well .period
mobile1581	i worked on the grade level promotion .period
mobile1582	i understand houston is to get some very cold weather in the next couple days !exclamation-point
mobile1585	i have a request .period
mobile1587	better than most recently .period
mobile1588	tells me he went through all collateral issues on these deals with wendi lebrocq in credit last week and everything tied exactly .period
mobile1589	i scratched my cornea playing basketball or have a conjunctivitis infection in my eye .period
mobile1590	i will not be available .period
mobile1591	are you interested in dinner tomorrow night at cafe express ?question-mark
mobile1592	i'm still running point until i find ward .period
mobile1593	i am working with mary joyce on that right now .period
mobile1594	that's all the email addresses i can think of now .period
mobile1595	i'll send you minutes .period
mobile1602	i also wanted to thank you for your flexibility in covering both the gas control desks and the measurement desk .period
mobile1603	travis is in charge .period
mobile1606	will call when i leave .period
mobile1607	through this account cash flows to corporate .period
mobile1608	thanks again for all of your help in this effort .period
mobile1609	let's make sure we are ready !exclamation-point
mobile1610	are you listening or video conferencing into this meeting ?question-mark
mobile1611	i am not expecting any of this today ,comma but it's nice to have things to look forward to .period
mobile1612	also ,comma i'm sure that you have heard the perils of enron .period
mobile1615	zero to five percent .period
mobile1616	i am in the pittsburg airport trying to forget about work .period
mobile1619	i don't know that i will be back monday .period
mobile1621	that is so sad .period
mobile1622	the power is executed ,comma i just need to get the cert signed .period
mobile1624	i would suggest you and mark address this together .period
mobile1626	their key decision maker did not show which is not a good sign .period
mobile1628	we are in a loop .period
mobile1629	if hair doesn't work then how about coffee ?question-mark
mobile1632	just make sure you work with kevin he may need assistance .period
mobile1633	um ,comma no sir .period
mobile1634	i appreciate you moving so quickly on this .period
mobile1635	if you need me i'm in the cafeteria for five minutes .period
mobile1636	i told him he's reporting to you and milly and he was pleased .period
mobile1637	what do you think about tracy and jim ?question-mark
mobile1638	are you in a good mood ?question-mark
mobile1639	thank you ,comma ricki .period
mobile1640	can you help get this cleared up ?question-mark
mobile1641	next week sounds fine for vacation .period
mobile1643	i have a high level in my office .period
mobile1645	i think we should try to sell some of our in the money positions .period
mobile1646	approximately half is due to organic cash flow .period
mobile1650	i'm working on a liquidity forecast .period
mobile1651	if we don't get it ,comma could be trouble .period
mobile1654	did you set up my corporate account for me ?question-mark
mobile1655	is there any way to just reduce the expenses for now ?question-mark
mobile1656	are you being a baby ?question-mark
mobile1657	so if we are going on a weekend ,comma why are you telling robyn ?question-mark
mobile1659	did you get this ?question-mark
mobile1660	maybe traffic will be light on thursday .period
mobile1661	mike is putting pressure on me .period
mobile1662	i thought we already reached an agreement to buy them .period
mobile1663	he also will have to honor noncompete .period
mobile1664	bill and maria ,comma please plan on calling in if at all possible .period
mobile1667	as to solicitation of employees back and forth ,comma it will be a negotiated deal term .period
mobile1668	i believe that now that we have signed ,comma there is no condition precedent that will allow for the board to say no to the deal .period
mobile1669	kind of like silent fireworks .period
mobile1670	would you please give me a call at your earliest convenience .period
mobile1671	can you get with mary and make sure ?question-mark
mobile1674	i hope never to have to go through that type of experience again .period
mobile1676	she has the game tomorrow .period
mobile1677	i'm on a plane .period
mobile1679	i sent it to her .period
mobile1680	what is the status of the pemex discussions ?question-mark
mobile1682	can you supplement the answer to the visa question ?question-mark
mobile1685	please let me know if you learn anything at the floor meeting .period
mobile1686	no other major projects underway that are impacted by enron's situation .period
mobile1687	i may try to call you a bit later on storage but we did not see that deal .period
mobile1688	has there been any announcements on the dynegy deal ?question-mark
mobile1689	i was going to call you but i hate to bother your holiday .period
mobile1690	remember blackberry doesn't work so well at home .period
mobile1692	he will walk tanya rohauer through the exact same steps tomorrow .period
mobile1694	at this point in time dynegy will be responsible for this debt ,comma if they exercise their rights under the preferred stock agreements ,comma which would leave them with common pledged to the lenders .period
mobile1695	i don't have the distraction of taking care of mimi .period
mobile1696	i think afraid of mass exodus .period
mobile1700	could you see where this stands ?question-mark
mobile1701	unless you really believe that you can pull off richard's project which sounds huge .period
mobile1702	we will need to get your signature on a few docs .period
mobile1703	did we get from lisa the appropriate internal account opening form from lisa yet ?question-mark
mobile1704	meet at arriving passenger area at lower level .period
mobile1706	sorry for the unfriendly greeting in the lobby .period
mobile1708	apparently ,comma john was told that i had a problem with this .period
mobile1709	i will submit that that may be the case today .period
mobile1710	yes i like perfume .period
mobile1711	i'm going to class .period
mobile1712	i have got to get out there ,comma as you can appreciate !exclamation-point
mobile1713	i was wondering if i could use some of the frozen veggies to make a casserole ?question-mark
mobile1716	see you on the third .period
mobile1718	smaller ,comma ad hoc meetings are more appropriate until the marketing agreements are finalized .period
mobile1719	hey ,comma so should we be nervous about kori coming back on monday ?question-mark
mobile1720	did we get ours back ?question-mark
mobile1721	she indicated that the indemnities in the contribution agreement covered the matters addressed in this draft and that she was told no more indemnities were to be made .period
mobile1722	i will be traveling out of the country next week .period
mobile1724	the rate case settlement represented a compromise approach to shifting more responsibility to the peak .period
mobile1725	diane has info from littler on its proposed training .period
mobile1726	let's leave it until we get going .period
mobile1728	they both have the sniffles and i have a sore throat .period
mobile1731	i realize this is short notice ,comma but if you don't have lunch plans for tuesday ,comma i'd love it if you could join kay mann and me for lunch at damians .period
mobile1732	do you have a number for him ?question-mark
mobile1738	i wasn't able to use the global phone in kazakhstan .period
mobile1740	i'll call you in the morning .period
mobile1741	i am afraid dan would worry if he knew about julia unless she has left him a message .period
mobile1743	we are all doing reasonably well ,comma i think .period
mobile1744	i may be in tomorrow too after i make sure alina won't freak out with the babysitter .period
mobile1751	go for the dollars .period
mobile1752	i do wish i knew .period
mobile1755	i'll need to come back soon ,comma but i think it is time for me to go .period
mobile1757	should i go ahead and make hotel and car reservations for california ?question-mark
mobile1758	i didn't think we had .period
mobile1761	we think it may be payable as a past expense .period
mobile1764	so i need your spreadsheets asap .period
mobile1767	do you need to be there ?question-mark
mobile1768	let me know if i need to make adjustments .period
mobile1769	hope you had a good weekend .period
mobile1770	had we not run into the el paso issues the number would have held .period
mobile1773	that would be a good idea .period
mobile1774	i hate not being there but i think these other meetings are big enough to have presence in omaha .period
mobile1777	i am on your calendar tomorrow afternoon and can explain further .period
mobile1778	east coast should be essentially flat .period
mobile1779	how's the share price ?question-mark
mobile1780	shelly ,comma there will be no one from my group unless i go up to meet with minnegasco .period
mobile1782	i guess we are almost there right ?question-mark
mobile1783	should we email this to you or fax to your house ?question-mark
mobile1785	i would say that we should honor the terms of any sale or acquisition agreement with regards to service bridging .period
mobile1787	jan has a lot of detail .period
mobile1788	need to watch closely .period
mobile1789	do we know what we need ?question-mark
mobile1790	what do you think ?question-mark
mobile1792	please send me a copy of the proposal and cover letter .period
mobile1793	i should have more info by our meeting this afternoon .period
mobile1794	does dan know about julia changing groups ?question-mark
mobile1796	i have no personal transactions with any enron entity .period
mobile1799	i need to help my mom get organized on some things .period
mobile1800	i can fill you in on more details later .period
mobile1801	okay i'm thru with appointment and am on my way in .period
mobile1802	she is taking over global finance legal .period
mobile1811	their lead won't tell me over the phone but we are schedule to get together at lunch to discuss .period
mobile1815	i think as long as enron is performing ,comma i'm not sure why there is all of this noise .period
mobile1816	also it appears no payment is required tomorrow .period
mobile1818	it will be very quiet all week .period
mobile1820	i forgot one person when we spoke on friday .period
mobile1822	i didn't know what her new title was supposed to be .period
mobile1826	i will need to have my memory refreshed .period
mobile1828	i can review afterwards and get back to you tonight .period
mobile1829	i don't plan for us to sign on ,comma we'll just wait for it to hit the board for vote .period
mobile1830	i hope he is having a fantastic time .period
mobile1832	please send me an email to let me know .period
mobile1833	if i leave here i will call your cell so you know how to reach me .period
mobile1835	but a friend recently rented one and used in europe .period
mobile1836	can mark ellenberg participate ?question-mark
mobile1838	i am available tomorrow afternoon .period
mobile1840	i can't wait to get my half of our prize !exclamation-point
mobile1841	i'm out of office till wednesday .period
mobile1842	please send tomy direct reports .period
mobile1843	i assume the severance question is only going to former employees ,comma but the doctor question goes to both current and former employees .period
mobile1846	danny i recommended on monday we cancel it .period
mobile1847	if so whitt is done ?question-mark
mobile1848	if he wants it .period
mobile1849	this is the second year in a row kevin has backed out on interviewing at the last minute .period
mobile1850	i appreciate your questions and comments and await your reply .period
mobile1851	wishing you both a very nice christmas !exclamation-point
mobile1853	it was very nice .period
mobile1855	i do not want to have to go to the cash committee every day .period
mobile1856	we will also need his fax number .period
mobile1859	i can't get online ,comma only blackberry ,comma but got gist of message .period
mobile1861	can you resend me the doyle email from last week ?question-mark
mobile1862	if so what was it ?question-mark
mobile1863	i'm in stan's office .period
mobile1866	it's death or dynegy ,comma with no clear leader .period
mobile1867	i don't think they formally backed out ,comma but effectively that is what has happened .period
mobile1871	i think he is utility player that can fill several roles ,comma but if your team won't need help ,comma i'm not sure if i need him .period
mobile1872	if you already have forwarded the memo please pass along the warning and ask them not to forward again .period
mobile1875	we will be managing our rates and we need to plan on software .period
mobile1876	invite frank ,comma laura ,comma tycholiz ,comma lagrasta ,comma breslau ,comma duran ,comma forster ,comma calger ,comma and foster .period
mobile1877	maybe she will be too preoccupied about whether she has a job or not !exclamation-point
mobile1880	we in the process of making a change .period
mobile1881	if you need john speak up now .period
mobile1883	we will not decide till next week as you know .period
mobile1885	in isolation ,comma all of these things are trivial .period
mobile1886	is there anything major going on ?question-mark
mobile1887	the troops just walked in .period
mobile1888	don't forget the wood .period
mobile1889	it is no problem .period
mobile1890	we need to give them a defined group for day one .period
mobile1893	i'm available by cell when you get data points .period
mobile1894	we are somewhat emasculated bystanders .period
mobile1899	this seems fine to me .period
mobile1900	i need a chauffeur when we arrive to take us either to king's cross to get a train or go all the way home .period
mobile1901	i will tell them .period
mobile1903	man i don't want to get sick again .period
mobile1908	seemed fine when i picked him up .period
mobile1909	we can work with it either way .period
mobile1911	i enjoyed our discussion very much .period
mobile1912	there is some type of retrade underway from the bill wise level .period
mobile1915	are you back in town ?question-mark
mobile1917	i am forwarding all the emails to her attention .period
mobile1919	let's make sure we have all bases covered and telephone tree in place .period
mobile1921	check and find out form ?question-mark
mobile1923	this is the crew .period
mobile1924	rick ,comma i have a number of contracts that the bankers want early tomorrow .period
mobile1927	i'm about to return to the office to see it .period
mobile1928	they played dirty ,comma michael hung tough .period
mobile1930	i thought you needed him to carry two people .period
mobile1931	i think in this case specific is better .period
mobile1932	pressure to finish my review !exclamation-point
mobile1934	san francisco was interconnect meeting .period
mobile1937	so it is all in ginger's hands now .period
mobile1940	mikey is invited also .period
mobile1942	why don't you ask shanna funkhouser for the details ?question-mark
mobile1944	what are the units ?question-mark
mobile1945	i'll ask ,comma he just came by .period
mobile1946	and be patient as there is no timeline .period
mobile1948	do i want to be represented by someone named lawless ?question-mark
mobile1949	i am leaving the lake .period
mobile1951	make sure you keep dot and drew in the loop on this stuff .period
mobile1952	i'm very sad ,comma a bit angry with the doctors ,comma and tired .period
mobile1954	i don't know how to get in touch with mike outside of the office .period
mobile1956	could i ask the two of you to please insure that there is a refreshed view on the legal risks relative to both our and el paso's litigation on east coast power .period
mobile1957	did you mean oxley ?question-mark
mobile1958	who should i contact regarding severance ?question-mark
mobile1961	check with vince strohmeyer .period
mobile1962	i heard peter and travis will be working with her .period
mobile1966	i will let you know the outcome when it's resolved .period
mobile1968	i'm taking wednesday off .period
mobile1969	i can get them .period
mobile1973	where do you want to meet to go over there ?question-mark
mobile1975	i am monitoring email .period
mobile1976	the objective seems to have gotten a little lost here .period
mobile1978	call me anytime for information .period
mobile1979	i will need you to resurrect your language on the gas for mitch tomorrow .period
mobile1981	will it be delivered ?question-mark
mobile1982	i will try to get a copy of the waiver .period
mobile1983	yes i would like to attend the conference and would love to get together while you are in town .period
mobile1986	after that meeting dari ,comma mary and i are going to review procedures for any changes .period
mobile1988	if jeff says it is okay ,comma then i take comfort in that given my relationship with jeff .period
mobile1990	i have received your messages and will respond accordingly .period
mobile1995	i likely will be arriving late ,comma so probably should pass .period
mobile1996	i'm not close enough right now to the discussion .period
mobile1998	bill is doing a great job on this .period
mobile1999	we may need more logins if there are multiple people required to schedule .period
mobile2000	then they should go home .period
mobile2002	brian is working this .period
mobile2003	on a comparative basis i can't justify more .period
mobile2004	if not ,comma i could use help with mulching the beds before i plant .period
mobile2005	what information ,comma if any ,comma do we owe him ?question-mark
mobile2006	i think you need to push wasaff .period
mobile2007	make sure they are current .period
mobile2008	was wondering if you and natalie connected ?question-mark
mobile2010	not at this time .period
mobile2011	do we have new york sorted out ?question-mark
mobile2012	can you try to get lavo and preview with him how these meetings go ?question-mark
mobile2014	there is a meeting thursday morning with dave and mary kay .period
mobile2017	sheila please talk to avashe .period
mobile2018	sorry i missed choir last night .period
mobile2023	see also if we can get something from lorna brennan .period
mobile2025	okay i'll go for a ticket .period
mobile2026	i'll give you my handwritten notes .period
mobile2027	there are still some remaining issues to be sorted out .period
mobile2028	john ,comma please send this to shelly .period
mobile2032	i don't know what i will be doing .period
mobile2035	not actually ,comma but realistically from business unrelated to the pipes .period
mobile2036	i am starting to get nervous about seeing kori tomorrow !exclamation-point
mobile2037	there are possible situations where we will need to call on them for coverage and assistance in this transition .period
mobile2039	i guess that's it for now .period
mobile2040	lisa now has everything .period
mobile2041	i will get georgie to call you .period
mobile2042	i'll give it to you tomorrow .period
mobile2043	i hate doing this ,comma but i owe it to michael ,comma since i really want to keep him in private school .period
mobile2044	if you have any follow up comments don't hesitate to call .period
mobile2046	i received the message from rod on california demand .period
mobile2051	i'm glad you are involved !exclamation-point
mobile2052	he doesn't want to give the trading positions .period
mobile2056	i'll call you when i get to the office .period
mobile2057	i would like an updated copy of the schedule you brought me with a description from the representatives about why the customer is saying that they haven't paid .period
mobile2058	it will all be public someday .period
mobile2060	we will get you a copy .period
mobile2061	you are welcome in palacios this weekend ,comma of course .period
mobile2062	thanks ,comma having a good time .period
mobile2064	if we have already signed up and can't get the money back then spread the word that is okay .period
mobile2065	please set something up .period
mobile2067	john ,comma if the meeting is monday i have jury duty .period
mobile2069	you of all people know how hard yesterday was for me .period
mobile2071	what is the shower at patsy's for ?question-mark
mobile2072	the wording needs to be tight and regardless of its enforceability make above clear .period
mobile2074	gary ,comma i would be glad to do a presentation for your group .period
mobile2076	i will give you a call tomorrow night when i get back to town .period
mobile2077	no ,comma at least not to my knowledge .period
mobile2078	i will follow up with him as soon as the dust settles .period
mobile2080	stop working weekends again .period
mobile2082	these are big storms and traffic isn't moving .period
mobile2085	do you have a number for steve ?question-mark
mobile2086	i vote for the latter .period
mobile2088	here is the message .period
mobile2089	we don't want to look bad to dyn .period
mobile2090	yes ,comma i will do so .period
mobile2091	for my money ,comma i think if we kept michael ,comma we could get rid of all of our analysts and associates ,comma and still handle our development deals and sales .period
mobile2093	talk to you soon .period
mobile2094	either way we will limit further funds from going out the door .period
mobile2095	lynn ,comma got to the office okay .period
mobile2096	some of it is ridiculous but some of it could go away if we changed a few things .period
mobile2097	i think he'll be done at his current offer ,comma do you want to give him more ?question-mark
mobile2098	it may be an hour .period
mobile2101	no ,comma i am not interested in getting certified in monterey bay .period
mobile2102	i think it is best for her not to work here ,comma as she obviously wasn't happy .period
mobile2103	jim please confirm to vince you are happy .period
mobile2105	if he'll sign no issues with barclays .period
mobile2107	please transfer the balance from my personal to my corporate .period
mobile2108	the assets are still warehoused off balance sheet and fortunately el paso's credit spreads have been trading in to our benefit .period
mobile2109	we're on the way .period
mobile2110	or are you going to be tied up with dinner ?question-mark
mobile2112	hope your week is going well .period
mobile2114	i don't think the stock price is the key piece of the puzzle ,comma as it doesn't impact value of the biz .period
mobile2117	is this the only time available ?question-mark
mobile2118	we just pulled schedules from the web .period
mobile2119	i can call jan at home so i can get access .period
mobile2125	i am going to be available in a few minutes .period
mobile2126	let me know if you want me to check the latest version .period
mobile2127	did you get the message to call mary kay ?question-mark
mobile2128	did not take the chance to tell about the outage .period
mobile2129	even michael was impressed .period
mobile2130	no there will be plenty of others .period
mobile2131	i woke up and couldn't get back to sleep .period
mobile2132	however let's wait and see if we can get one more draft done for wednesday .period
mobile2133	what is the purpose of this ?question-mark
mobile2135	i have not seen any numbers nor have i heard from faith .period
mobile2136	first objective is to keep electricity flowing .period
mobile2139	i will try to reach you on wednesday .period
mobile2140	what do you think about that sir ?question-mark
mobile2145	i plan to work tomorrow some on the data and can hopefully get you something for friday .period
mobile2147	if you guys already mulched last week ,comma then i can manage the planting on my own .period
mobile2148	they are specifically concerned about the current intercompany notes .period
mobile2149	nice weather for it .period
mobile2150	i think those are the right dates .period
mobile2152	accounting has been able to look in and find that they actually did have a third party .period
mobile2153	but i hope to see you at kari's house .period
mobile2154	please send me an email describing the changes he is requesting .period
mobile2155	do you want to go to the cafeteria for lunch ?question-mark
mobile2156	is there a meeting with kevin howard today on this ?question-mark
mobile2160	i would suggest adding an acknowledgement at the bottom ,comma where the person accepts the terms and conditions of the assignment letter and also authorizes the company to deduct the amounts described in the letter from final paycheck ,comma vacation pay or other amounts to be paid to employee .period
mobile2161	this message is about new building tour .period
mobile2162	i enjoyed our discussion very much and was very impressed with your accomplishments and experience .period
mobile2164	i can be there within the hour .period
mobile2167	do you want to fax it to my hotel ?question-mark
mobile2168	would you like to take cam ?question-mark
mobile2169	he walked me through outstanding issues on alamac that he is working with duran and heather to resolve .period
mobile2170	i do not need the bill to go to my home address .period
mobile2171	i'm sitting in the airport waiting on the plane .period
mobile2172	i meant to try and explain ,comma not to redo .period
mobile2173	cool is it not .period
mobile2175	i just told kathy to send an email to my direct reports .period
mobile2178	can i get electronic copies of these ,comma they have volumes and margins and appear to back up the revenue projections .period
mobile2181	is derrick okay with it ?question-mark
mobile2182	so i'll see you at the airport ?question-mark
mobile2183	did you differ from me ?question-mark
mobile2184	if anyone asks just say i'm in dallas and you don't know why .period
mobile2186	my husband is in indonesia on business ,comma so don't be surprised if i reply in the middle of the night when kids are asleep and i can concentrate .period
mobile2188	thanks for your help in quickly setting this up .period
mobile2189	hang in there guys .period
mobile2192	it will interfere with every dinner ,comma theatre ,comma social event you plan .period
mobile2194	just in case we haven't invited any of them .period
mobile2195	didn't get a commitment .period
mobile2197	please email me randy pais and david marshall's phone numbers .period
mobile2198	are you sure i don't need to be there ?question-mark
mobile2199	go ahead and notify .period
mobile2200	i wasn't going to mention it ,comma but i was wondering if he had heard about it yet .period
mobile2201	i want the payment from the final bill to go to the corporate account as well .period
mobile2202	it should be cynthia barow instead .period
mobile2204	i doubt that it is forecasted .period
mobile2206	if i hear anything i will let you know .period
mobile2208	see ,comma it's cold enough for hot chocolate !exclamation-point
mobile2209	i am getting lots of questions .period
mobile2210	so the language does have value .period
mobile2211	i'll email later tonight .period
mobile2212	how did they get onto our floor ?question-mark
mobile2213	all the kids were cute .period
mobile2214	if you want i can try to nail down some names for these people but i'm not sure that makes a whole lot of sense .period
mobile2217	i agree with morris .period
mobile2220	i consider the no notice to be part of the market imbalance for this analysis .period
mobile2224	i will take a look at this today .period
mobile2225	dominion's lawyer left me a message that they are sticking with the termination .period
mobile2226	was panda able to adjust their timetable for today's teleconference ?question-mark
mobile2227	great job ,comma kevin .period
mobile2230	i'm waiting for my close up .period
mobile2231	if we can't find anyone ,comma we'll have to interview fewer people .period
mobile2234	on mahonia margining ,comma i spoke with mike garberding .period
mobile2236	will you come get me ?question-mark
mobile2237	was it an actual downgrade or just that they wouldn't agree not to do so ?question-mark
mobile2238	i will conference in for thursday's customer service meeting .period
